111111111111111111
1P00000000X1C00X01
111011101111101111
1C0000000000000X01
1X0000000000000001
10101011X1C1101001
1X00000000000000E1
111111111111111111
